000000002000000
000000000001100
110000111110000
111001100011100
000001100030001
111111110001001
