111111111111111111111100000000000000000000000000000000000000000000000000000000000000000000000111111111111111111111111111
111111111111111111111100000000000000000000000000000000000000000000000000000000000000000000000111111111111111111111111111
111111111111111111111111100000000000000000000000000000000000000000000000000000000000000000000111111111111111111111111111
111111111111111111111111110000000000000000000000000000000000000000000000000000000000000000000111111111111111111111111111
111111111111111111110111100000000000000000000000000000000000000000000000000000000000000000000011111111111111111111111111
111111111111111111110111100000000000000000000000000000000000000000000000000000000000000000000011111111111111111111111111
111111111111111111110000000000000000000000000000000000000000000000000000000000000000000000000011111111111111111111111111
111111111111111111110000000000000000000000000000000000000000000000000000000000000000000000000011111111111111111111111111
111111111111111111110000000000000000000000000000000000000000000000000000000000000000000000000011111111111111111111111111
111111111111111111110000000000000000000000000000000000000000000000000000000000000000000000000011111111111111111111111111
111111111111111111110000000000000000000000000000000000000000000000000000000000000000000000000011111111111111111111111111
111111111111111111010000000000000000000000000000000000000000000000000000000000000000000000000011111111111111111111111111
111111111111111111100000000000000000000000000000000000000000200000000000000000000000000000000011111111111111111111111111
111111111111111111100000000000000000000000000000000000000000000000000000000000000000000000000011111111111111111111111111
111111111111111111100000000000000000000000000000000000000000000000000000000000000000000000000011111111111111111111111111
111111111111111111100000000000000000000000000000000000000000000000000000000000000000000000000011111111111111111111111111
111111111111111111100000000000000000000000000000000000000000000000000000000000000000000000000011111111111111111111111111
111111111111111111110000000000000000000000000000000000000000000000000000000000000000000000000011111111111111111111111111
111111111111111111111000000000000011100000000000000000000000000000000000000000110000000000000001111111111111111111111111
111111111111111111111100000000000011100000000000000000000000000000000000000001111000000000000001111111111111111111111111
111111111111111110111100000000000011100000000000000000000000000000000000000001111000000000000001111111111111111111111111
111111111111111111111110000000000011100000000000000000000000000000000000000010110000000000000001111111111111111111111111
111111111111111111111110000000000011100000000000000000000000000000000000000111100000000000000001111111111111111111111111
111111111111111111111110000000000010100000000000000000000000000000000000000111100000000000000001111111111111111111111111
111111111111111111111110000000000011100000000000000000000000000000000000001111000000000000000001111111111111111111111111
111111111111111111111000000000000101100000000000000000000000000000000000001111000000000000000001111111111111111111111111
111111111111111111111000000000000110100000000000000000000000000000000000011110000000000000000001111111111111111111111111
111111111111111111101000000000000101100000000000000000000000000000000000011110000000000000000001111111111111111111111111
111111111111111111111000000000000111000000000000000000000000000000000000111100000000000000000001111111111111111111111111
111111111111111111111000000000000111000000000000000000000000000000000000111000000000000000001101111111111111111111111111
111111111111111111111000000000000111000000000000000111111111100000000001111000000000000000011101111111111111111111111111
111111111111111111111000000000000111000000000000001111111111100000000011110000000000000000011101111111111111111111111111
111111111111111111111000000000001111000000000000001011111111100000000011110000000000000000011111111111111111111111111111
111111111111111111101000000000001011000000000000001111111111100000000111100000000000000000011111111111111111111111111111
111111111111111111111000000000001111000000000000000000000011100000000111100000000000000000011111111111111111111111111111
111111111111111111110000000000001111000000000000000000000011100000001111000000000000000000011111111111111111111111111111
111111111111111111110000000000001111000000000000000000000011100000001111000000000000000000011111111111111111111111111111
111111111111111111110000000000001110000000000000000000000011100000011110000000000000000000011111111111111111111111111111
111111111111111111110000000000001110000000000000000000000011100000011100000000000000000000011111111111111111111111111111
111111111111111111110000000000001110000000000000000000000011100000111100000000000000000000001111111111111111111111111111
111111111111111111010000000000011110000000000000000000000011100001111000000000000000000000001111111111111111111111111111
111111111111111111110000000000010110000000000000000000000011100001111000000000000000000000001111111111111111111111111111
111111111111111111110000000000010110000000000000000000000011000011110000000000000000000000001111111111111111111111111111
111111111111111111110000000000010110000000000000000000000111000011110000000000000011111111111111111111111111111111111111
111111111111111111110000000000011110000000000000000000000111000110100000000000011111111111111111111111111111111111111111
111111111111111111110000000000011100000000000000000000000111000111100000000000111111111111111111111111111111111111111111
111111111111111100000000000000011100000000000000000000000111001111000000000000111111111111111111111111111111111111111111
111111111111111100000000000000011100000000000000000000000111001110000000000000111111111111111111111111111111111111111111
111111111111111100000000000000011100000000000000000000000111010010000000000000111111000000000111111111111111111111111111
111111111111111100000000000000111100000000000000000000000111111100000000000000000000000000000111111111111111111111111111
111111111111111100000000000000111100000000000000000000000111111100000000000000000000000000000111111111111111111111111111
111111111111111100000000000000101100000000000000000000000111111000000000000000000000000000000111111111111111111111111111
111111111111111100000000000000111100000000000000000000000111111000000000000000000000000000000111111111111111111111111111
111111111111111100000000000000101000000000000000000000000111110000000000000000000000000000000111111111111111111111111111
111111111111111100000000000000111000000000000000000000000111110000000000000000000000000000000111111111111111111111111111
111111111111111110000000000000111000000000000000000000000111100000000000000000000000000000000110111111111111111111111111
111111111111111110000000000000111000000000000000000000000101000000000000000000000000000000000110111111111111111111111111
111111111111111110000000000000111000000000000000000000001111000000000000000000000000000000000110111111111111111111111111
111111111111111110000000000001111000000000000000000000001110000000000000000000000000000000000101111111111111111111111111
111111111111111110000000000001111000000000000000000000001110000000000000000000000000000000000011111111111111111111111111
111111111111111131000000000001111000000000000000000000001100000000000000000000000000000000000011101111111111111111111111
111111111111111111000000000001111000000000000000000000000000000000000000000000000000000000000011101111111111111111111111
111111111111111111000000000001111000000000000000000000000000000000000000000000000000000000000010101111111111111111111111
111111111111111131000000000001010000000000000000000000000000000001111111111111111110000000000011101111111111111111111111
111111111111111110000000000001110000000000000000000000000000000001111111111111111110000000000000001111111111111111111111
111111111111111110000000000000000000000000000000000000000000000001111111111111111110000000000000001111111111111111111111
111111111111111110000000000000000000000000000000000000000000000001111111000000000000000000000000001111111111111111111111
111111111111111110000000000000000000000000000000000000000000000000000000000000000000000000000000001111111111111111111111
111111111111111110000000000000000000000000000000000000000000000000000000000000000000000000000000000011111111111111111111
111111111111111110000000000000000000000000000000000000000000000000000000000000000000000000000000000011111111111111111111
111111111111111111111111110000000000000000000000000000000000000000000000000000000000000000000000000001111111111111111111
111111111111110101111111110000000000000000000000000000000000000000000000000000000000000000000000000001111111111111111111
111111111111111111111111110000000000000000000000000000000000000000000000000000000000000000000000000001111111111111111111
111111111111111111111111110000000000000000000000000000000000000000000000000000000000000000000000000001111111111111111111
111111111111111111111111110000000000000000000000000000000000000000000000000000000000000000000000000000000011111111111111
111111111111111111111111110000000000000000000000000000000000000000000000000000000000000000000000000000000001111111111111
111111111111111111111111110000000000000000000000000000000000000000000000000000000000000000000000000000000001111111111111
111111111111111111111111100000000000000000000000000000000000000000000000000000000000000000000000000000000001111111111111
111111111111111111111111000001111111000000000000000000000000000000000000000000000000000000000000000000000001111111111111
111111111111111111111000000011111111111111111111111111111110000000000000000000000000000000000000000000000001111111111111
111111111111111111100000000011111111111111111111111111111111111111111111111111000000000000000000000000000001111111111111
111111111111111100000000000011111111111111111111111111111111111111111111111111100000000000000000000000000001111111111111
111111111111111000000000000000011111111111111111111111111111111111111111111111100000000000000000000000000001111111111111
111111111111111000000000000000000000000000000000000000111111111111111111111111100000000000000003000000000001111111111111
111111111111111000000000000000000000000000000000000000000000000000000000000001000000000000000000000000000001111111111111
111111111111110000000000000000000000000000000000000000000000000000000000000000000000000000000000000000000001111111111111
111111111111000000000000000000000000000000000000000000000000000000000000000000000000000000000000000000000001111111111111
111111111100000000000000000000000000000000000000000000000000000000000000000000000000000000000000000000000001111113311111
111111110000000000000000000000000000000000000000000000000000000000000000000000000000000000000000000000000001111113331111
111111000000000000000000000000000000000000000000000000000000000000000000000000000000000000000000000000000001111133311111

